{
  "a": 1,
  "b": 2,
  "c": 3,
  "d": 4,
  "e": 5,
  "f": 6,
  "g": 7,
  "h": 8,
  "i": 9,
  "j": 10,
  "k": 11,
  "l": 12,
  "m": 13,
  "n": 14,
  "o": 15,
  "p": 16,
  "r": 17,
  "s": 18,
  "t": 19,
  "u": 20,
  "w": 21,
  "y": 22,
  "ঁ": 23,
  "ং": 24,
  "অ": 25,
  "আ": 26,
  "ই": 27,
  "উ": 28,
  "ঋ": 29,
  "এ": 30,
  "ও": 31,
  "ক": 32,
  "খ": 33,
  "গ": 34,
  "ঘ": 35,
  "ঙ": 36,
  "চ": 37,
  "ছ": 38,
  "জ": 39,
  "ঝ": 40,
  "ঞ": 41,
  "ট": 42,
  "ঠ": 43,
  "ড": 44,
  "ঢ": 45,
  "ণ": 46,
  "ত": 47,
  "থ": 48,
  "দ": 49,
  "ধ": 50,
  "ন": 51,
  "প": 52,
  "ফ": 53,
  "ব": 54,
  "ভ": 55,
  "ম": 56,
  "য": 57,
  "র": 58,
  "ল": 59,
  "শ": 60,
  "ষ": 61,
  "স": 62,
  "হ": 63,
  "়": 64,
  "া": 65,
  "ি": 66,
  "ী": 67,
  "ু": 68,
  "ূ": 69,
  "ৃ": 70,
  "ে": 71,
  "ৈ": 72,
  "ো": 73,
  "ৌ": 74,
  "্": 75,
  "ৎ": 76
}