{
  "a": 1,
  "b": 2,
  "c": 3,
  "d": 4,
  "e": 5,
  "f": 6,
  "g": 7,
  "h": 8,
  "i": 9,
  "j": 10,
  "k": 11,
  "l": 12,
  "m": 13,
  "n": 14,
  "o": 15,
  "p": 16,
  "r": 17,
  "s": 18,
  "t": 19,
  "u": 20,
  "v": 21,
  "y": 22,
  "ं": 23,
  "अ": 24,
  "आ": 25,
  "इ": 26,
  "ई": 27,
  "उ": 28,
  "ऊ": 29,
  "ऋ": 30,
  "ए": 31,
  "औ": 32,
  "क": 33,
  "ख": 34,
  "ग": 35,
  "घ": 36,
  "च": 37,
  "छ": 38,
  "ज": 39,
  "झ": 40,
  "ञ": 41,
  "ट": 42,
  "ठ": 43,
  "ड": 44,
  "ढ": 45,
  "ण": 46,
  "त": 47,
  "थ": 48,
  "द": 49,
  "ध": 50,
  "न": 51,
  "प": 52,
  "फ": 53,
  "ब": 54,
  "भ": 55,
  "म": 56,
  "य": 57,
  "र": 58,
  "ल": 59,
  "व": 60,
  "श": 61,
  "ष": 62,
  "स": 63,
  "ह": 64,
  "़": 65,
  "ा": 66,
  "ि": 67,
  "ी": 68,
  "ु": 69,
  "ू": 70,
  "ृ": 71,
  "े": 72,
  "ै": 73,
  "ो": 74,
  "ौ": 75,
  "्": 76
}