{
  "a": 1,
  "b": 2,
  "c": 3,
  "d": 4,
  "e": 5,
  "f": 6,
  "g": 7,
  "h": 8,
  "i": 9,
  "j": 10,
  "k": 11,
  "l": 12,
  "m": 13,
  "n": 14,
  "o": 15,
  "p": 16,
  "r": 17,
  "s": 18,
  "t": 19,
  "u": 20,
  "v": 21,
  "y": 22,
  "ಂ": 23,
  "ಅ": 24,
  "ಆ": 25,
  "ಇ": 26,
  "ಉ": 27,
  "ಊ": 28,
  "ಋ": 29,
  "ಎ": 30,
  "ಒ": 31,
  "ಕ": 32,
  "ಖ": 33,
  "ಗ": 34,
  "ಘ": 35,
  "ಚ": 36,
  "ಜ": 37,
  "ಟ": 38,
  "ಠ": 39,
  "ಡ": 40,
  "ಣ": 41,
  "ತ": 42,
  "ಥ": 43,
  "ದ": 44,
  "ಧ": 45,
  "ನ": 46,
  "ಪ": 47,
  "ಫ": 48,
  "ಬ": 49,
  "ಭ": 50,
  "ಮ": 51,
  "ಯ": 52,
  "ರ": 53,
  "ಲ": 54,
  "ಳ": 55,
  "ವ": 56,
  "ಶ": 57,
  "ಷ": 58,
  "ಸ": 59,
  "ಹ": 60,
  "ಾ": 61,
  "ಿ": 62,
  "ೀ": 63,
  "ು": 64,
  "ೂ": 65,
  "ೃ": 66,
  "ೆ": 67,
  "ೇ": 68,
  "ೈ": 69,
  "ೊ": 70,
  "ೋ": 71,
  "ೌ": 72,
  "್": 73
}