{
  "a": 1,
  "b": 2,
  "c": 3,
  "d": 4,
  "e": 5,
  "f": 6,
  "g": 7,
  "h": 8,
  "i": 9,
  "j": 10,
  "k": 11,
  "l": 12,
  "m": 13,
  "n": 14,
  "o": 15,
  "p": 16,
  "r": 17,
  "s": 18,
  "t": 19,
  "u": 20,
  "v": 21,
  "y": 22,
  "ં": 23,
  "અ": 24,
  "આ": 25,
  "ઇ": 26,
  "ઈ": 27,
  "ઉ": 28,
  "ઊ": 29,
  "ઋ": 30,
  "એ": 31,
  "ક": 32,
  "ખ": 33,
  "ગ": 34,
  "ઘ": 35,
  "ચ": 36,
  "છ": 37,
  "જ": 38,
  "ઞ": 39,
  "ટ": 40,
  "ઠ": 41,
  "ડ": 42,
  "ણ": 43,
  "ત": 44,
  "થ": 45,
  "દ": 46,
  "ધ": 47,
  "ન": 48,
  "પ": 49,
  "ફ": 50,
  "બ": 51,
  "ભ": 52,
  "મ": 53,
  "ય": 54,
  "ર": 55,
  "લ": 56,
  "ળ": 57,
  "વ": 58,
  "શ": 59,
  "ષ": 60,
  "સ": 61,
  "હ": 62,
  "ા": 63,
  "િ": 64,
  "ી": 65,
  "ુ": 66,
  "ૂ": 67,
  "ૃ": 68,
  "ે": 69,
  "ૈ": 70,
  "ૉ": 71,
  "ો": 72,
  "ૌ": 73,
  "્": 74
}