{
  "a": 1,
  "b": 2,
  "c": 3,
  "d": 4,
  "e": 5,
  "g": 6,
  "h": 7,
  "i": 8,
  "j": 9,
  "k": 10,
  "l": 11,
  "m": 12,
  "n": 13,
  "o": 14,
  "p": 15,
  "r": 16,
  "s": 17,
  "t": 18,
  "u": 19,
  "v": 20,
  "y": 21,
  "z": 22,
  "அ": 23,
  "ஆ": 24,
  "இ": 25,
  "ஈ": 26,
  "உ": 27,
  "ஊ": 28,
  "எ": 29,
  "ஏ": 30,
  "ஒ": 31,
  "ஓ": 32,
  "க": 33,
  "ங": 34,
  "ச": 35,
  "ஞ": 36,
  "ட": 37,
  "ண": 38,
  "த": 39,
  "ந": 40,
  "ன": 41,
  "ப": 42,
  "ம": 43,
  "ய": 44,
  "ர": 45,
  "ற": 46,
  "ல": 47,
  "ள": 48,
  "ழ": 49,
  "வ": 50,
  "ா": 51,
  "ி": 52,
  "ீ": 53,
  "ு": 54,
  "ூ": 55,
  "ெ": 56,
  "ே": 57,
  "ை": 58,
  "ொ": 59,
  "ோ": 60,
  "ௌ": 61,
  "்": 62
}