{
  "ં": 1,
  "અ": 2,
  "આ": 3,
  "ઇ": 4,
  "ઈ": 5,
  "ઉ": 6,
  "ઊ": 7,
  "ઋ": 8,
  "એ": 9,
  "ક": 10,
  "ખ": 11,
  "ગ": 12,
  "ઘ": 13,
  "ચ": 14,
  "છ": 15,
  "જ": 16,
  "ઞ": 17,
  "ટ": 18,
  "ઠ": 19,
  "ડ": 20,
  "ણ": 21,
  "ત": 22,
  "થ": 23,
  "દ": 24,
  "ધ": 25,
  "ન": 26,
  "પ": 27,
  "ફ": 28,
  "બ": 29,
  "ભ": 30,
  "મ": 31,
  "ય": 32,
  "ર": 33,
  "લ": 34,
  "ળ": 35,
  "વ": 36,
  "શ": 37,
  "ષ": 38,
  "સ": 39,
  "હ": 40,
  "ા": 41,
  "િ": 42,
  "ી": 43,
  "ુ": 44,
  "ૂ": 45,
  "ૃ": 46,
  "ે": 47,
  "ૈ": 48,
  "ૉ": 49,
  "ો": 50,
  "ૌ": 51,
  "્": 52
}