{
  " ": 1,
  "a": 2,
  "b": 3,
  "c": 4,
  "d": 5,
  "e": 6,
  "f": 7,
  "g": 8,
  "h": 9,
  "i": 10,
  "j": 11,
  "k": 12,
  "l": 13,
  "m": 14,
  "n": 15,
  "o": 16,
  "p": 17,
  "r": 18,
  "s": 19,
  "t": 20,
  "u": 21,
  "v": 22,
  "y": 23,
  "z": 24,
  "ਂ": 25,
  "ਅ": 26,
  "ਆ": 27,
  "ਇ": 28,
  "ਈ": 29,
  "ਉ": 30,
  "ਊ": 31,
  "ਏ": 32,
  "ਕ": 33,
  "ਖ": 34,
  "ਗ": 35,
  "ਘ": 36,
  "ਚ": 37,
  "ਛ": 38,
  "ਜ": 39,
  "ਝ": 40,
  "ਟ": 41,
  "ਠ": 42,
  "ਡ": 43,
  "ਢ": 44,
  "ਣ": 45,
  "ਤ": 46,
  "ਥ": 47,
  "ਦ": 48,
  "ਧ": 49,
  "ਨ": 50,
  "ਪ": 51,
  "ਫ": 52,
  "ਬ": 53,
  "ਭ": 54,
  "ਮ": 55,
  "ਯ": 56,
  "ਰ": 57,
  "ਲ": 58,
  "ਵ": 59,
  "ਸ": 60,
  "ਹ": 61,
  "਼": 62,
  "ਾ": 63,
  "ਿ": 64,
  "ੀ": 65,
  "ੁ": 66,
  "ੂ": 67,
  "ੇ": 68,
  "ੈ": 69,
  "ੋ": 70,
  "ੌ": 71,
  "੍": 72,
  "ੜ": 73,
  "ੰ": 74,
  "ੱ": 75
}