{
  "ಂ": 1,
  "ಅ": 2,
  "ಆ": 3,
  "ಇ": 4,
  "ಉ": 5,
  "ಊ": 6,
  "ಋ": 7,
  "ಎ": 8,
  "ಒ": 9,
  "ಕ": 10,
  "ಖ": 11,
  "ಗ": 12,
  "ಘ": 13,
  "ಚ": 14,
  "ಜ": 15,
  "ಟ": 16,
  "ಠ": 17,
  "ಡ": 18,
  "ಣ": 19,
  "ತ": 20,
  "ಥ": 21,
  "ದ": 22,
  "ಧ": 23,
  "ನ": 24,
  "ಪ": 25,
  "ಫ": 26,
  "ಬ": 27,
  "ಭ": 28,
  "ಮ": 29,
  "ಯ": 30,
  "ರ": 31,
  "ಲ": 32,
  "ಳ": 33,
  "ವ": 34,
  "ಶ": 35,
  "ಷ": 36,
  "ಸ": 37,
  "ಹ": 38,
  "ಾ": 39,
  "ಿ": 40,
  "ೀ": 41,
  "ು": 42,
  "ೂ": 43,
  "ೃ": 44,
  "ೆ": 45,
  "ೇ": 46,
  "ೈ": 47,
  "ೊ": 48,
  "ೋ": 49,
  "ೌ": 50,
  "್": 51
}