{
  "ं": 1,
  "अ": 2,
  "आ": 3,
  "इ": 4,
  "ई": 5,
  "उ": 6,
  "ऊ": 7,
  "ऋ": 8,
  "ए": 9,
  "औ": 10,
  "क": 11,
  "ख": 12,
  "ग": 13,
  "घ": 14,
  "च": 15,
  "छ": 16,
  "ज": 17,
  "झ": 18,
  "ञ": 19,
  "ट": 20,
  "ठ": 21,
  "ड": 22,
  "ढ": 23,
  "ण": 24,
  "त": 25,
  "थ": 26,
  "द": 27,
  "ध": 28,
  "न": 29,
  "प": 30,
  "फ": 31,
  "ब": 32,
  "भ": 33,
  "म": 34,
  "य": 35,
  "र": 36,
  "ल": 37,
  "व": 38,
  "श": 39,
  "ष": 40,
  "स": 41,
  "ह": 42,
  "़": 43,
  "ा": 44,
  "ि": 45,
  "ी": 46,
  "ु": 47,
  "ू": 48,
  "ृ": 49,
  "े": 50,
  "ै": 51,
  "ो": 52,
  "ौ": 53,
  "्": 54
}