{
  " ": 1,
  "ਂ": 2,
  "ਅ": 3,
  "ਆ": 4,
  "ਇ": 5,
  "ਈ": 6,
  "ਉ": 7,
  "ਊ": 8,
  "ਏ": 9,
  "ਕ": 10,
  "ਖ": 11,
  "ਗ": 12,
  "ਘ": 13,
  "ਚ": 14,
  "ਛ": 15,
  "ਜ": 16,
  "ਝ": 17,
  "ਟ": 18,
  "ਠ": 19,
  "ਡ": 20,
  "ਢ": 21,
  "ਣ": 22,
  "ਤ": 23,
  "ਥ": 24,
  "ਦ": 25,
  "ਧ": 26,
  "ਨ": 27,
  "ਪ": 28,
  "ਫ": 29,
  "ਬ": 30,
  "ਭ": 31,
  "ਮ": 32,
  "ਯ": 33,
  "ਰ": 34,
  "ਲ": 35,
  "ਵ": 36,
  "ਸ": 37,
  "ਹ": 38,
  "਼": 39,
  "ਾ": 40,
  "ਿ": 41,
  "ੀ": 42,
  "ੁ": 43,
  "ੂ": 44,
  "ੇ": 45,
  "ੈ": 46,
  "ੋ": 47,
  "ੌ": 48,
  "੍": 49,
  "ੜ": 50,
  "ੰ": 51,
  "ੱ": 52
}