{
  "அ": 1,
  "ஆ": 2,
  "இ": 3,
  "ஈ": 4,
  "உ": 5,
  "ஊ": 6,
  "எ": 7,
  "ஏ": 8,
  "ஒ": 9,
  "ஓ": 10,
  "க": 11,
  "ங": 12,
  "ச": 13,
  "ஞ": 14,
  "ட": 15,
  "ண": 16,
  "த": 17,
  "ந": 18,
  "ன": 19,
  "ப": 20,
  "ம": 21,
  "ய": 22,
  "ர": 23,
  "ற": 24,
  "ல": 25,
  "ள": 26,
  "ழ": 27,
  "வ": 28,
  "ா": 29,
  "ி": 30,
  "ீ": 31,
  "ு": 32,
  "ூ": 33,
  "ெ": 34,
  "ே": 35,
  "ை": 36,
  "ொ": 37,
  "ோ": 38,
  "ௌ": 39,
  "்": 40
}